1,1,1,1,1,1,1,1,1,1,1,1,1,1,1,1,1,1,1,1,1,1,1,1,1,1,1,1,1,1,1,1,1,1,1,1,1,1,1,1,1,1
1,2,0,0,0,0,0,0,0,0,0,0,0,1,0,0,0,2,0,0,0,1,0,0,2,0,0,1,0,0,0,0,0,2,0,0,0,0,0,0,0,1
1,0,0,0,0,0,Y,0,0,0,0,0,0,1,1,1,0,Z,0,1,1,1,0,CD,0,0,0,1,0,0,0,KL,0,0,0,0,LM,0,0,0,0,1
1,0,0,0,0,0,0,0,0,0,0,0,0,1,0,0,0,0,0,0,0,1,0,0,0,0,0,1,0,0,0,0,0,0,0,0,0,0,0,0,0,1
1,0,X,0,0,0,0,0,0,0,0,0,0,1,0,H,0,0,0,I,0,1,0,0,0,0,0,1,0,0,0,0,0,0,0,0,0,0,0,0,0,1
1,0,U,0,0,0,0,0,V,0,0,0,0,1,0,0,0,0,0,0,0,1,0,0,0,0,0,1,0,0,0,0,0,0,0,0,0,0,0,0,0,1
1,0,0,0,0,0,0,0,0,0,0,0,0,1,0,0,K,0,J,0,0,1,0,0,0,0,0,1,0,0,0,0,0,0,0,0,0,0,0,0,0,1
1,0,S,0,0,0,0,0,0,0,0,0,T,1,0,0,0,0,0,0,0,1,0,0,0,DE,0,1,0,0,0,0,0,0,0,0,0,0,0,0,0,1
1,0,0,0,0,0,0,0,0,0,0,0,0,1,0,0,0,0,0,0,0,1,0,0,0,0,0,1,0,0,0,0,0,0,0,0,0,0,0,0,0,1
1,1,1,1,1,0,0,0,0,0,0,0,0,0,0,AB,0,0,0,BC,0,1,0,0,0,0,0,1,0,RS,0,0,0,0,0,YY,0,0,0,0,0,1
1,0,0,0,1,0,0,0,0,0,0,0,0,0,0,0,0,0,0,0,0,1,0,0,0,0,EF,1,0,0,0,0,0,0,0,0,0,0,0,0,0,1
1,0,2,0,1,0,0,0,0,0,0,0,0,1,0,0,ZE,0,0,0,0,1,0,0,0,0,0,1,0,0,0,0,0,0,0,0,0,0,0,0,0,1
1,0,0,0,0,0,0,0,0,0,G,0,0,1,0,0,0,0,0,0,0,0,0,0,0,0,0,1,0,0,0,0,0,0,0,0,0,0,0,0,0,1
1,0,F,0,L,0,0,0,0,0,0,0,CC,1,0,0,0,0,0,0,0,0,0,0,0,0,0,1,0,QR,0,0,0,0,0,0,0,0,0,0,0,1
1,0,0,0,0,0,0,0,0,0,0,R,0,1,0,0,0,0,0,0,0,1,0,FG,0,0,0,1,0,0,0,0,0,0,0,0,0,0,0,0,0,1
1,0,0,0,0,0,0,0,0,0,0,0,0,1,0,0,0,0,0,0,0,1,0,0,0,0,0,1,0,0,0,0,0,0,0,0,0,0,0,0,0,0
1,0,C,0,0,0,0,Q,0,0,0,D,0,1,0,AA,0,0,0,BB,0,1,0,0,0,GH,0,1,0,0,0,0,XX,0,0,0,0,0,0,0,0,0
1,0,0,0,M,0,0,0,0,0,0,0,E,1,0,0,0,0,0,0,0,1,0,0,0,0,0,1,0,0,0,0,0,0,0,0,0,0,0,0,0,4
1,1,1,1,1,0,A,0,0,0,0,0,B,1,1,1,0,ZZ,0,1,1,1,0,HI,0,0,0,0,1,0,0,,0,0,0,0,0,0,0,0,0,0
1,0,0,0,0,0,0,0,0,0,0,0,P,1,0,0,0,0,0,0,0,1,0,0,0,0,0,0,0,0,0,0,0,0,0,0,0,0,0,0,0,0
1,0,2,0,0,0,0,0,0,0,0,0,0,1,0,0,0,2,0,0,0,1,0,0,0,0,0,0,0,0,0,0,0,0,0,0,0,0,0,0,0,1
1,0,0,0,1,0,O,0,0,0,0,0,3,1,0,0,0,0,0,0,0,1,0,IJ,0,LL,0,0,0,0,0,0,0,MN,0,2,0,0,0,NO,0,1
1,1,1,1,1,1,1,1,1,1,1,1,1,1,1,1,1,1,1,1,1,1,1,1,1,1,1,1,1,1,1,1,1,1,1,1,1,1,1,1,1,1

zombie:A,B
zombie:C,D
zombie:L,M
zombie:O,P
zombie:Q,R
turret:E,2
zombie:F,G
zombie:S,T
zombie:U,V
zombie2:X,Y
zombie2:H,I
zombie:AB,BC
zombie:CD,DE
trap:Z,2
trap:ZZ,2
zombie2:J,K
zombie2:EF,FG
zombie:FG,GH
zombie2:HI,IJ
zombie2:KL,LM
zombie2:MN,NO
zombie:QR,RS
turret:XX,2
turret:YY,2
turret:LL,2
zombie2:AA,BB
turret:ZE,2